Stage 1
######
#P   #
#  oO#
# Oo #
######
=====
Stage 2
 #####
##P  ##
#  #  #
# o0o #
#  O  #
## O ##
 #####
=====
Stage 3
##### 
#P  ##
#Oo0 #
#  # #
#    #
######
=====
Stage 4
 #####  
##O  ###
#  # oP#
#  # # #
# 0  oO#
#    ###
######
====
Stage 6
######  
#P   ## 
# Oo0 ##
# #oO  #
#      #
########
